111111111111111
100022222220001
101012121212101
102022002222001
101010101010101
100000000000001
101212101010101
102222220000001
101010101010101
100022200022001
101012101010101
100022000000001
101010101010101
100022222200001
111111111111111